8 8
. . . . . . @ .
. . . . . . . .
. . . . . . . .
. . . . @ . . .
. . @ . . . . .
. . . . . . . .
. . . . @ . @ .
. @ . . . . . .
7
5 4 4 4
3 0 5 2
0 5 7 4
2 3 2 4
4 4 0 4
5 2 5 0
7 4 7 7
